1111111111111
100100010C001
10000000000C1
111C011111001
1P0011E000001
1111111111111